1111111111
1001001001
1000000001
1000000001
1000000001
1000000101
1000000101
1110000101
1110000121
1111111111