1111111111
1001001111
1101010001
1101010101
1001000101
1011111101
1000000001
1101101111
1000101111
1111111111