1111001101
1201001101
1100010001
1101010101
1101000101
1001111101
1000110001
1001110011
1000100111
1110000111