1111881101
1201501151
1100010001
1101010101
1151000151
1001111101
1000110001
1001110011
1000100111
1110750111