1011001101
1501551051
1000000001
1000110001
1000000001
1000000151
1110500101
1100000101
1100000121
1111001101