1011001101
1001001001
1000000001
1000110001
1000000001
1000000101
1110000101
1100000101
1100000121
1111001101