1111881111
1011551101
1000330001
1010330151
1000330001
1510330101
1000330001
1010330101
1500330051
1011071101