1111001111
1011331101
1000330001
1010330101
1000330001
1010330101
1000330001
1010330101
1000330001
1011001101