1881111881
1313443131
1500330051
1010330101
1000330001
1010330101
1000335001
1510330101
1210330101
1111071111