1001111001
1313443131
1000330001
1010330101
1000330001
1010330101
1000330001
1010330101
1210330101
1111001111