1111111111
1020000201
1000000001
1000330001
1000330001
1000330001
1000330001
1000000001
1000000001
1001111001